0,1,2,67,67,67,168,168,168,169
15,67,67,67,67,67,183,183,183,184
30,67,67,67,67,67,183,183,183,184
45,67,67,67,67,67,183,183,183,184
67,67,67,67,67,67,183,183,183,184
67,67,67,67,67,67,183,5,183,184
67,67,67,67,67,67,183,20,183,184
182,183,183,183,183,196,183,183,183,184
182,183,183,183,183,183,183,183,183,164
182,183,183,183,183,183,183,183,178,179
182,183,183,183,183,183,183,183,193,194
195,196,198,198,198,198,206,207,208,209
